1111111111111111111111111111111111111111
1P0000000000000001E000100000000000000C01
1000000000000000011110100000000000000001
1000000000000000000000000000000000000001
1000000000000000000000000000000000000001
1000000000000000000000000000000000000001
10000000000000000S0000000000000000000001
1000000000000000000000000000000000000001
1000000000000000000000000000000000000001
10000000S0000000000000000000000000000001
1000000000000000000000000000000000000001
10000000000000000000000000000S0000000001
1000000000000000000000000000000000000001
1111111111111111111111111111111111111111
